███████████████████████████████████████████████████
█ █                 █     █   █             █     █
█ ███ █████████████ █ █ █ █ █ ███ █ ███████ ███ █ █
█     █    E      █ █ █ █   █   █ █   █   █ █   █ █
███████ █ ███ █████ ███ ███████ ███ █ █ █ █ █ ███ █
█   █   █ █   █     █   █     █   █ █ █ █   █ █ █ █
█ █ █ ███ █████ █████ ███ █ █ ███ ███ █ █████ █ █ █
█ █   █ █     █       █   █ █   █   █ █ █     █   █
█ █████ █████ █████████████ █ █████ █ █ █ █ ███ ███
█       █ █       █         █ █   █   █ █ █ █ █   █
███████ █ █ █████ █ █ █████████ █ █████ ███ █ ███ █
█       █ █ █   █ █ █ █         █ █     █   █   █ █
█ ███████ █ █ ███ █ █ █ █████████ █ █████ ███ █ █ █
█ █       █ █       █ █ █       █   █     █ █ █   █
█ ███ ███ █ █ █████████ ███████ ███████ ███ █ █████
█   █   █ █ █   █     █       █       █   █ █ █   █
███ █ ███ █ █████ ███ ███████ █ █ ███ █ █ █ █ ███ █
█ █ █ █   █     █ █ █     █   █ █ █ █ █ █ █ █     █
█ █ ███ ███████ █ █ █ █████ █████ █ █ ███ █ █████ █
█ █   █ █     █   █ █ █     █     █   █   █     █ █
█ ███ █ █ ███ █████ █ █ █████ █████ ███ ███████ █ █
█ █   █     █   █   █   █  S  █   █     █       █ █
█ █ ███ █████ █ ███ █████ █████ █████████ ███████ █
█   █   █     █   █           █ █   █     █       █
█ █████ █ ███████ ███████████ █ █ █ █ █ ███ ███████
█     █ █ █     █   █     █   █   █ █ █ █   █     █
█████ █ █ █ ███████ █ ███ █ ███████ █ █ █ ███ █ █ █
█ █   █ █ █       █   █ █   █       █ █   █   █ █ █
█ █ █████ █ █████ █████ ███████ ███ █ █████████ ███
█ █   █   █   █ █ █             █   █         █   █
█ ███ █ █████ █ █ █ █ ███ █████ █████████████ ███ █
█     █ █       █   █ █   █   █ █           █     █
█ █████ █ ███████ ███ █████ █ ███ █████████ █████ █
█   █   █ █     █   █ █     █     █   █       █   █
███ ███ ███ ███ █████ █ █████████████ █ ███████ ███
█ █ █   █     █     █ █   █     █     █   █   █ █ █
█ █ █ ███ █████████ █ ███ ███ █ ███ █ ███ █ █ █ █ █
█   █     █         █   █     █     █   █   █   █ █
█ █████ ███ █████████ █ ███████████████ █████████ █
█     █ █   █       █ █               █     █     █
█████ █ █ ███ █████ █ █ ███████████████████ ███ ███
█   █ █ █ █       █   █                   █   █   █
█ █ █ ███ ███████████ █████████████████ █ ███ ███ █
█ █ █ █   █     █   █ █   █     █     █ █   █     █
█ █ █ █ ███ ███ █ █ █ █ █ █ █ ███ ███ █ █████████ █
█ █ █ █ █   █ █   █ █   █   █ █   █     █     █   █
█ █ █ █ █ ███ █████ █████████ █ █████████ █ █ █ ███
█ █   █       █     █       █ █           █ █ █   █
█ █████████████ █████ █ █████ █████████████ █████ █
█               █     █                   █       █
███████████████████████████████████████████████████
